XXXXXXXXXXXXXXXXX
XOOOOOOOOOOOOOOOX
XOXOOOOOOOOOOOOOX
XOOOOOOOOOOOOOOOX
XOOOOOOOOOOOOOOOX
XOOOOOOOOOOOOOOOX
XOOOOOOOOOOOOOOOX
XOOOOOOOOOOOOOOOX
XOOOOOOOOOOOOOOOX
XOOOOOOOOOOOOOOOX
XOOOOOOOOOOOOOOOX
XOOOOOOOOOOOOOOOX
XOOOOOOOOOOOOOOOX
XOOOOOOOOOOOOOOOX
XOOOOOOOOOOOOOOOX
XOOOOOOOOOOOOOOOX
XXXXXXXXXXXXXXXXX