XXXXXXXXXXXXXXXXX
XOOOOOOOOOOOOOOOX
XOXXOOOOOOOOOOOOX
XOOOOOOXOOOXOOOOX
XOOOOOOOOOOOOOOOX
XOOOXXXOOOOOOOOOX
XOOOOOOOOOOOOOOOX
XOOOOOOOOOOOOOOOX
XOOOOOOOOOOOOOOOX
XOOOOOOOOOOXOOOOX
XOOOOOOOOOOXOOOOX
XOOXOOOOOOOXOOOOX
XOOOXOOOOOOOOOOOX
XOOOOXOOOOOOOOOOX
XOOOOOXOOOOXOOOOX
XOOOOOOOOOOOOOOOX
XXXXXXXXXXXXXXXXX