XXXXXXXXXXXXXXXXX
XOOOOOOOOOOOOOOOX
XOXXOOOOOOOOOOOOX
XOOOOOOOOOOOOOOOX
XOOOOOOOOOOOOOOOX
XOOOOOOOOOOOOOOOX
XOOOOOOOOOOOOOOOX
XOOOOOOOOOOOOOOOX
XOOOOOOOOOOOOOOOX
XOOOOOOOOOOOOOOOX
XOOOOOOOOOOOOOOOX
XOOOOOOOOOOOOOOOX
XOOOOOOOOOOOOOOOX
XOOOOOOOOOOOOOOOX
XOOOOOOOOOOOOOOOX
XOOOOOOOOOOOOOOOX
XXXXXXXXXXXXXXXXX